1111111111111111111111111111111111
1000000C0000000C00000C00000E000001
1010010100100000101001000000010101
101001001010101P001001000000010101
110010000C00C0000000000000000000C1
1111111111111111111111111111111111