1111111111
10E00000C1
1C0000P001
1111111111