111111111111111
1P110
1011
1011
10000
111111111111111