1111111
1000P01
1011C01
1001101
1000101
1E001C1
1111111