1111111111111111111111111111111111111111111111111111111111111111111111111111111111111111111
1P00000000000000000000000000000000000000000000000000000000000000000000000000000000000000001
1000000000000000000000000000000000000000000000000000000000000000000000000000000000000000001
1000000000000100111110000010011111000001001111100000100111110000010011111000001001111100001
10011111000001001111100000100000000000010C1111100000000000000000000011111C000000000000000E1
1111111111111111111111111111111111111111111111111111111111111111111111111111111111111111111