1111111111111
1P01000000001
1000010000001
100C0100000E1
111111