11111111111111111111111111
1P011111111111110000000E11
11011111111111110110110111
11000100010001000010100011
11011101110101011110101011
11000100010001010010101011
11110101110011011010101011
11000100010101000010100011
11011111111111110110011111
1C000000000000000110000C11
11111111111111111111111111