111111
1PEC01
100001
100011
100001
111111