1111111111111111111111111111111
1000000C000000000011111000E0001
10001110000000000E0000000000001
10000E00011C0000000000000100001
1111111111111111111111111111111